####################################
#.................................#
#..###########....#####....###....#
#..#.........#....#...#....#.#....#
#..#..I......#....# N #....#.#....#
#..#.........#....#...#....###....#
#..###########....#####............
#..................................#
#..................................#
####################################
