################################
#..............................#
#..#######..#######..#######...#
#..# 201 #..# 202 #..# 203 #...#
#..#######..#######..#######...#
#..............................#
#..#######..#######...###......#
#..# 204 #..# 205 #...#D#......#
#..#######..#######...#.#......#
#..............................#
#............#######..#######..#
#............# 206 #..# 207 #..#
#............#######..#######..#
#..............................#
#....................#######...#
#....................# 208 #...#
#....................#######...#
################################