####################################
#..................................#
#..###########....#####....###.....#
#..#.........#....#...#....#S#.....#
#..#..I......#F...# N #....#.#.....#
#..#.......B..........#....#.#.....D
#..###########....#####............#
#....................LLOOXX~~,,TT%%#
#....................LLOOXX~~,,TT%%#
####################################
