####################################
#..................................#
#..###########....#####....###.....#
#..#.........#....#...#....#D#.....#
#..#..I......#....# N #....#.#.....#
#..#.........#....#...#....#.#.....D
#..###########....#####............#
#..................................#
#..................................#
####################################
