####################################
#..................................#
#..###########....#####....###.....#
#..#.........#....#...#....#.#.....#
#..#..I......#....# N #....#.#.....#
#..#.........#....#...#....###...D.#
#..###########....#####............#
#..................................#
#..................................#
####################################
