####################################
#..................................#
#..#OOOOOOOOO#....#...#....#.#.....#
#D.#OOOOOOOOO#....# N #....#.#.....#
####################################
