####################################
#..................................#
#..#.........#....#...#....#.#.....#
#D.#..I......#....# N #....#.#.....#
####################################
